21
12
FFFFFFFFFFFFFFFFFFFFF
FFFFFFFFFFFFFFFFFFFFF
FFFFFIFFFWWIIWWDWWFFF
FFFFFIFFFWSSSSSSSWFFF
FFFFFIFFFISSSSSSSWFFF
FFFFFFFFFWWWWDDSSWFFF
FFFFFFFFFSSSSSSSSWFFF
FFFFFFFFFWSSSSWIWWFFF
DFFFDFFFFWSSSSSSSWFFF
FFFDDFFFFWWWWWWWWWFFF
FDFFFFFFFFFFFFFFFFFFF
FFFFFFFFFFFFFFFFFFFFF