33
19
WWWWWWWWWWWWWWWWWWWWWWWWWWWWWWWWW
WFFFFFFFFFFFFFFFFFFFWWWWWFFFFFFFW
WFFFFFFFFFFFFFFFFFFFWWWWWFFFFFFFW
WFFFFFFFFFFFFFFFFFFFWWWWWFFFFFFFW
WWWWWWWWWWWWWFFFFFFFWWWWWFFFFFFFW
WWWWWWWWWWWWWFFFFFFFWWWWWFFFFFFFW
WWWWWWWWWWWWWFFFFFFFWWWWWFFFFFFFW
WWWWWWWWWWWWWFFFFFFFWWWWWFFFFFFFW
WFFFFFFFFFFFFFFFFFFFFFFFFFFFFFFFW
WFFFFFFFFFFFFFFFFFFFFFFFFFFFFFFFW
WFFFFFFFFFFFFFFFFFFFFFFFFFFFFFFFW
WFFFFFFFWWWWWFFFFFFFWWWWWWWWWWWWW
WFFFFFFFWWWWWFFFFFFFWWWWWWWWWWWWW
WFFFFFFFWWWWWFFFFFFFWWWWWWWWWWWWW
WFFFFFFFWWWWWFFFFFFFWWWWWWWWWWWWW
WFFFFFFFWWWWWFFFFFFFFFFFFFFFFFFFW
WFFFFFFFWWWWWFFFFFFFFFFFFFFFFFFFW
WFFFFFFFWWWWWFFFFFFFFFFFFFFFFFFFW
WWWWWWWWWWWWWWWWWWWWWWWWWWWWWWWWW