unlocked
37
21
brick_wall>A
water>B
stone_slab>C
bricks_window>D
planks>E
metal_door>F
grass>G
A|A|A|A|A|A|A|A|A|A|A|A|A|A|A|A|A|A|A|A|A|A|A|A|A|B|B|B|B|B|B|B|B|B|B|B|B|
A|C|C|C|C|C|C|C|C|D|D|E|E|E|E|E|E|E|E|E|E|E|E|E|D|B|B|B|B|B|B|B|B|B|B|B|B|
A|C|F|C|C|C|C|C|C|A|A|E|E|E|E|A|E|E|E|E|E|E|E|E|D|B|B|B|B|B|B|B|B|B|B|B|B|
A|C|C|C|C|F|C|C|C|E|E|E|E|E|E|A|E|E|F|F|F|E|E|E|D|B|B|B|B|B|B|B|B|B|B|B|B|
A|C|C|C|C|C|C|C|C|E|E|E|E|E|E|A|E|E|E|E|E|E|E|E|D|B|B|B|B|B|B|B|B|B|B|B|B|
A|E|E|A|D|D|A|A|A|A|A|E|E|E|E|A|E|E|E|E|F|F|A|A|A|B|B|B|B|B|B|B|B|B|B|B|B|
A|E|E|E|E|E|E|E|E|E|E|E|E|E|E|A|E|E|E|E|E|E|E|E|A|A|A|A|D|D|D|D|D|D|D|D|A|
A|E|E|E|E|E|E|E|E|E|E|E|E|E|E|E|E|E|E|E|E|E|E|E|E|E|E|E|E|E|E|E|E|E|E|E|A|
A|E|E|F|E|E|E|E|E|E|E|E|E|E|E|E|E|E|E|E|E|E|E|E|E|E|E|E|E|E|E|E|E|E|E|E|A|
A|E|E|E|E|E|E|E|E|E|A|E|E|E|E|E|E|F|E|E|E|E|E|E|A|E|E|E|E|E|E|E|F|E|E|E|A|
A|E|E|E|E|A|D|F|D|A|A|D|D|D|D|A|A|F|F|F|A|A|A|A|A|A|A|E|E|E|E|E|A|A|A|F|A|
A|E|E|E|E|A|E|E|E|A|F|F|F|F|F|F|A|E|E|E|E|C|C|C|C|C|C|C|C|C|C|C|C|C|A|F|A|
A|D|D|E|E|E|E|E|E|A|F|F|F|F|F|F|A|E|E|E|E|C|C|C|C|C|C|C|C|C|D|C|C|C|A|E|A|
A|E|E|E|E|A|E|E|E|A|A|D|D|D|D|A|A|E|E|E|E|A|C|C|C|C|C|C|C|C|D|C|C|C|A|E|A|
A|E|E|E|E|A|F|F|F|A|G|G|G|G|G|G|A|E|E|E|E|A|C|C|C|C|C|C|C|C|D|C|C|C|D|E|A|
A|E|E|E|E|E|E|E|E|E|G|G|G|G|G|G|F|C|C|D|A|A|C|C|C|C|C|C|C|C|D|C|C|C|D|E|A|
A|F|F|E|E|E|E|E|E|A|G|G|A|G|G|G|F|C|C|C|C|C|C|C|C|C|C|C|C|D|C|C|C|C|D|E|A|
A|E|E|E|E|E|E|E|E|F|G|D|B|D|G|G|F|C|C|C|C|C|C|C|C|D|D|D|D|C|C|C|C|C|D|E|A|
A|E|E|D|E|E|E|E|E|F|G|G|A|G|G|G|A|C|C|C|C|C|C|C|C|C|C|C|C|C|C|C|C|A|A|E|A|
A|E|E|D|E|E|E|E|E|F|G|G|G|G|G|G|C|C|C|C|C|C|C|C|C|C|C|C|C|C|C|C|F|F|E|E|A|
A|A|A|A|A|A|A|A|A|A|G|G|G|G|G|G|A|A|A|A|A|A|A|A|A|A|A|A|A|A|A|A|A|A|A|A|A|
