21
12
FFFFFFFFFFFFFFFFFFFFF
FFFFFFFFFFFFFFFFFFFFF
FFFFFWWWWWFFFFFFFFFFF
FFFFFFFFFIFFFFFFFFFFF
FFFFFDFFFWFFFFFFFFFFF
FFFFFWWWWWFFFFFFFFFFF
FFFFFFFFFFFFFFFFFFFFF
FFFFFFFFFFFFFFFFFFFFF
FFFFFFFFFFFFFFFFFFFFF
FFFWWWWWWWWWWWFFFFFFF
FFFFFFFFFFFFFFFFFFFFF
FFFFFFFFFFFFFFFFFFFFF